2
10 10
0010010010
0100100101
1001001010
0011110101
0111101010
1001010100
0010101101
0101010010
1010100100
0101001000
1 1
2 3
5 7
3 3
000
111
010
0 0
1 1
2 0